1
28
29
0
                        #EEE#
                       ##   #
                      ##    #
                     ##    ##
                    ##    ##
                   ##    ##
                  ##    ##
                 ##    ##
                ##    ##
               ##    ##
              ##    ##
             ##    ##
            ##    ##
           ##    ##
          ##    ##
         ##    ##
        ##    ##
       ##    ##
      ##    ##
     ##    ##
    ##    ##
   ##    ##
  ##    ##
 ##    ##
##P   ##
#P P ##
# P ##
#####
