118 8
F0                                                                           F1                                       
########################################################################     ##############                           
#FFFFFFFFFFFFFFFFFFFFFFFFFFFFFFFFF                                     #     #S           #                           
#FFFFFFFFFFFFFFFFFFFFFFFFFFFFFFFFFF                                    #     #            #                           
#FFFFFFFFFFFFFFFFFFFFFFFFFFFFFFFFF                                     #     #            #                           
#FFFFFFFFFFFFFFFFFFFFFFFFFFFFFFFFF  P                                 S#     #            #######################     
##################################F#####################################     #                                 S#     
                                 #E#                                         ####################################     
