118 8
F0                                                                           F1                                       
########################################################################     ##############                           
#FFFFFFFFFFFFFFFFFFFFFFFFFFFFFF002345                                  #     #FFFFFFFFFFFF#                           
#FFFFFFFFFFFFFFFFFFFFFFFFFFFFFFF02345                                  #     #FFFFFFFFFFFF#                           
#FFFFFFFFFFFFFFFFFFFFFFFFFFFFFFF02345                                  #     #FFFFFFFFFFFF#                           
#FFFFFFFFFFFFFFFFFFFFFFFFFFFFFFF02345                                 S#     #FFFFFFFFFFFF#######################     
##################################3#####################################     #FFFFFFFFFFFFFFFFF0345            S#     
                                 #E#                                         ####################################     
