118 8
F0                                                                           F1                                       
########################################################################     ##############                           
#FFFFFFFFFFFFFFFFFFFFFFFFFFFFFFF                                       #     #FFFFFFFFFFFF#                           
#FFFFFFFFFFFFFFFFFFFFFFFFFFFFFFFF                                      #     #FFFFFFFFFFFF#                           
#FFFFFFFFFFFFFFFFFFFFFFFFFFFF F                                        #     #FFFFFFFFFFFF#                           
#FFFFFFFFFFFFFFFFFFFFFFFFF FFFF                                       S#     #FFFFFFFFFFFF#######################     
################################## #####################################     #FFFFFFFFFFFFFFFFF                S#     
                                 #E#                                         ####################################     
