50 6
F0                       F1                       
####################     ####################     
#         #        #     #                  #     
#S        #       S#     #S                S#     
#         #        #     #                  #     
##############E#####     ####################     
