185 15
F0                                   F1                                   F2                                   F3                                   F4                                   
################################     ################################     ################################     ################################     ################################     
#      |                |      #     #S             |               #     #S       |            |       S#     #3210   0|     OO     |       S#     #45      |            |        #     
#      |    OOO  OOO    |      #     #                   OOO  OOO   #     #        |   O    O   |        #     #3200   0|            |    O   #     #55 O    |            |        #     
#           OOO  OOO           #     #    OOOOO     |               #     #        ||||||  ||||||        #     #320   0 ||||||  ||||||        #     #        ||||||  ||||||        #     
#      |                |      #     #    OOOOO     ||||||||  ||||||#     #|||||                         #     #|||||0000345                  #     #|||||                         #     
####||||                ########     #                          #####     #        ||||||||||||||    #####     #    |111||||||||||||||    #####     #        ||||||||||||||    #####     
E           OO      S       S  E     #                   S      #S  #     #  O |   |    OOOO         #S  #     #   O|3232345         |    #S  #     #   O|   |                 #S  #     
E           OO      S          E     #                   S          #     #  O |                |        #     #   O|343|345 OOOO             #     #    |                |        #     
####||||                ########     #||||||  ||||||            #####     #    |   ||||||||||||||    #####     #   54545||||||||||||||    #####     #O   |   ||||||||||||||    #####     
#      |                |      #     #             |     OOOOO      #     #|||||                         #     #|||||555                      #     #|||||                         #     
#           OOO  OOO           #     #        OO   |     OOOOO      #     #        ||||||  ||||||        #     #        ||||||  ||||||        #     #        ||||||  ||||||        #     
#      |    OOO  OOO    |      #     #    OO       |                #     #        |   O    O   |        #     #    O   |            |        #     #        |            |   O    #     
#      |                |      #     #             |               S#     #S       |            |       S#     #S       |     OO     |       S#     #        |            |       S#     
################################     ################################     ################################     ################################     ################################     
