21 12
F0                   
################     
#              #     
#       F F    #     
#       FFF    #     
#       FFF    #     
#|||||||FFF    #     
#    FFFFF F   #     
#      FFF     #     
E        F     #     
#              #     
################     
