118 8
F0                                                                           F1                                       
########################################################################     ##############                           
#FFFFFFFFFFFFFFFFFFFFFFFFFFFFFFFF                                      #     #FFFFFFFFFFFF#                           
#FFFFFFFFFFFFFFFFFFFFFFFFFFFFFFFFF                                     #     #FFFFFFFFFFFF#                           
#FFFFFFFFFFFFFFFFFFFFFFFFFFFFFFFFF                                     #     #FFFFFFFFFFFF#                           
#FFFFFFFFFFFFFFFFFFFFFFFFFFFFFFF                                      S#     #FFFFFFFFFFFF#######################     
################################## #####################################     #FFFFFFFFFFFFFFFFFFFF             S#     
                                 #E#                                         ####################################     
