118 8
F0                                                                           F1                                       
########################################################################     ##############                           
#FF00345A989A                                                          #     #0346        #                           
#FFF00056789ABC                                                        #     #234567      #                           
#FFFFF06789A B                                                         #     #3345        #                           
#FFFF006789A           P                                              S#     #45666       #######################     
################################## #####################################     #65677                            S#     
                                 #E#                                         ####################################     
