33 14
F0                               
############################     
#                          #     
#                          #     
#                          #     
#                          #     
#                          #     
#                          #     
##### ###### ###### ########     
    # #    # #    # #            
    # #    # #    # #            
    # ###### ###### #            
    #               #            
    ########E########            
