110 51
F0                                                     F1                                                     
##################################################     ##################################################     
#                           4444445              #     #   00   00  0112544545                          #     
#                        4533333355              #     #    0       00000333455                         #     
#                       5432222234               #     #       0     00 00024455                        #     
#              |||||||   4321111||||0|||||5555555E     #       0      00  043545                        #     
#              |  O  |   4355000|000 0000|4544444#     #                  002345                        #     
#              |     |   55540 0    0    |3433333#     #                   02345                        #     
#              |     |   54430           |0000002#     #                   00345                        #     
#  O           |    O|   54300            0  0 00#     #                    0045           O            #     
#              |         5530            |0      #     #                00   045555                     #     
#              |     |   5400           1|00  0  #     #               000000045445                     #     
#              |||||||   550 0    | ||| 1|       #     #0 0            0 0004555345                     #     
#                         50      0 0500120  0  0#     #0 000         1    00012345   |||||||           #     
#                        550      0005305        #     #0005||||||      1    012345   |O                #     
#                        540       0553000       #     #1111|3330      |1   0012345   | O   |           #     
#                        54000    00543210       #     #3222|0030      |0   0512345   |   1 |           #     
#       1                55440   0045552300      #     #3311| 000           0555555   |     |           #     
#       ||| |||           555000005554333500     #     #4220|    1          044545    ||||| |           #     
#       |     |5555555   |  |||111235445450      #     #4310 000            004345                      #     
#       |55555|5454445555| O  |222245|||||||     #     #5550|0201            02345           2          #     
#       |45445|4333345444|    |43333 |     |0    #     #5454|||0|            02345          3           #     
#       |00334|0000000335|    |444444|    5|00   #     #54330000            000345                      #     
#  5555 | 0322|0  00 0024|   O|5 5  5|    500    #     #54320 0  0            0445  ||||||1||||         #     
#  54455| 0003|0   0  000|    |      |    5|     #     #54330  1             00345  |     2   |         #     
# 555350||  |||       0  |    |      |     |   0 #     #55550 1             002345  |     2   |         #     
# 543250  0        0     |    |      |     | 000 #     # 54500              002345  |     2   |         #     
# 54321000          0  00|    |      |     |00400#     #55000              0 00345  |    12   |         #     
# 5432000           00002||||||      |     |55555#     #000                   0045  ||||||2||||         #     
# 54320             00512345         |     |     #     #                     0 055             1        #     
# 5||||||0           0524345         |||||||     #     #                   0  005  1                    #     
#  |    |          0 0533555                     #     #             ||    |  005                       #     
#  |   O|001        005445    S                  #     #          |         00 05    S                  #     
#  |  5 |00 10  0    05555              O        #     #                 0 |00005                       #     
#  | 554|0 00   000  0334                        #     #              0 000|32345      ||||||           #     
#  | 543|0000     00002345                       #     #           000  033|33455      |    |           #     
#  | 55322250000 00553234  55555555              #     #0           000 04444455       |    |           #     
#  |  54|33543100|||||||5|||444444||||||||       #     #0    0  0  |||||||||555        |    |           #     
#  ||||||45532212|554455444|333334|      |       #     #00    00000012345              |    |           #     
#       555433433|443333333|222234|      |       #     #3000  05555512355              |    |           #     
# 5       5544444|432222223|111234|      |       #     #4540 302543222345              |    |           #     
# 63       555555|532111112|000554| 555  |       #     #55500003543333345              |    |           #     
# 84        5    |442000055|  0005|55455 |     S #     # 5433333545444455                   |         S #     
#8               |5500  004|    04|44345 |       #     # 544444445555555||||||              |           #     
E                |540    00|    00|32345 |       #     # 55555555       |    |         ||||||           #     
#S               |5200           0000345 |       #     #S               |    |                          #     
# 4             5|3210            | 0345 |       #     # 8              |    |                          #     
#  3            5432100             ||||||       #     #  5             |    |                          #     
#               5||||||   |        00123         #     #                || |||                          #     
#                 54320           0021234        #     #                                                #     
##################################################     ##################################################     
