############################
#                          #
#                          #
#                          #
#                          #
#                          #
#                          #
############ ###############
           # #              
           # #              
           # #              
           # #              
           #E#              
