118 8
F0                                                                           F1                                       
########################################################################     ##############                           
#FFFFFFFFFFFFF                                                         #     #FFFFFFFFFF  #                           
#FFFFFFFFFFFFFF                                                        #     #FFFFFFFFFF  #                           
#FFFFFFFFFFFFFF                                                        #     #FFFFFFFFFF  #                           
#FFFFFFFFFFFFF                                                        S#     #FFFFFFFFFF  #######################     
################################## #####################################     #FFFFFFFF F                      PS#     
                                 #E#                                         ####################################     
