118 8
F0                                                                           F1                                       
########################################################################     ##############                           
#                                                                      #     #            #                           
#                                                                      #     #            #                           
#                                                                      #     #            #                           
#                                                                      #     #            #######################     
################################## #####################################     #                                  #     
                                 #E#                                         ####################################     
