118 8
F0                                                                           F1                                       
########################################################################     ##############                           
#FFFFFFFFFFFFFFFFFFFFFFFFFFFF                                          #     #FFFFFFFFFFFF#                           
#FFFFFFFFFFFFFFFFFFFFFFFFFFFF                                          #     #FFFFFFFFFFFF#                           
#FFFFFFFFFFFFFFFFFFFFFFFFFFFF                                          #     #FFFFFFFFFFFF#                           
#FFFFFFFFFFFFFFFFFFFFFFFFFFFF                                         S#     #FFFFFFFFFFFF#######################     
################################## #####################################     #FFFFFFFFFFFFFFFFF                S#     
                                 #E#                                         ####################################     
