118 8
F0                                                                           F1                                       
########################################################################     ##############                           
#S                                                                     #     #S           #                           
#F                                                                     #     #            #                           
# F                                                                    #     #            #                           
#                                                                     S#     #            #######################     
################################## #####################################     #   P                             S#     
                                 #E#                                         ####################################     
