118 8
F0                                                                           F1                                       
########################################################################     ##############                           
#SFFFFFFFFFF                                                           #     #S           #                           
#FFFFFFFFFFF                                                           #     #            #                           
#FFFFFFFFFFF                                                           #     #            #                           
#FFFFFFFFFF                                                          PS#     #            #######################     
################################## #####################################     #                                 S#     
                                 #E#                                         ####################################     
