33 14
F0                               
############################     
#   2891          9993     #     
#   1399         999       #     
#      991      9          #     
#        93    9      2    #     
# 122    194  9            #     
#   1 32899959             #     
##### ######8###### ########     
    # #    #8#    # #            
    # #    #8#    # #            
    # ######8###### #            
    #   9999855555  #            
    ########E########            
