1
13
44
0
#####################
#                   E
#                   E
#   #################
#   #
#   #
#P P#
# P #
#P P#
# P #
#P P#
# P #
#####
