2
5 
20
2
(-1 -1 -1) (1 2 1)
(-1 -1 -1) (1 2 18)
####################
#         #        #
#S       P#       S#
#         #        #
##############E#####

5
20
2
(0 2 1) (-1 -1 -1)
(0 2 18) (-1 -1 -1)
####################
#                  #
#S                S#
#                  #
####################
