5
13
#####
#   #
#   #
#   #
#   #
#   #
#   #
#   #
#   #
# P #
#   #
#   #
##E##
