1
13
5
0
#####
#   #
#   #
#   #
#   #
#   #
#   #
#   #
#   #
# P #
#   #
#   #
##E##
