1
13
28
0
############################
#   PPPP       PPPPPPP     #
#   PP              PPP    #
#      PPPPPPP             #
#                          #
# PPPP               PPPP  #
#    PPPPP                 #
############ ###############
           # #
           # #
           # #
           # #
           #E#
