2
5
5
1
(-1 -1 -1) (1 1 1)
#####
# P #
#   #
# S #
#####

5
5
1
(0 3 2) (-1 -1 -1)
#####
#S  #
#   #
#   #
##E##
