2
5
5
1
##E##
#   #
#  F#
#F  #
##S##

5
5
1
#####
# P #
#O  #
#   #
##S##

