1
5
10
0
##########
#   #    #
#  FD    E
#   #    #
#######################
#P                    E
#######################
