2
8
8
1
(-1 -1 -1) (1 6 1)
########
# F    #
#      #
#      #
# #    #
# #OOO #
#S#    E
########

8
8
1
(0 6 1) (-1 -1 -1)
########
#    P #
#      #
#      #
#      #
# OO  O#
#S#    #
########
