16
11
################
#              #
#        P     #
#              #
#     P        #
#########      #
#              #
#              #
E              #
#              #
################
