8
8
########
#      #
#   F  #
#   F  #
# #    #
# #  O #
#P#    E
########
