2
5
5
1
-1 -1 -1
##E##
#   #
#   #
# S #
#####

5
5
1
0 3 2
#####
# P #
#   #
# S #
#####
