11
12
###########
#P       P#
#         #
#         #
#         #
#         #
##### #####
#         #
#         #
#         #
#         #
#####E#####
