2
5
5
##E##
#   #
#   #
#   #
##S##

5
5
#####
# P #
#   #
#   #
##S##

