1
11
16
0
################
#  P   PPPP  P #
#    P   P     #
#  P  P PPPP P #
#     P        #
##   ###########
#              #
#              #
E              #
#              #
################
