1
8
8
0
########
#      #
#      #
#      #
# #    #
# #  O #
#P#    E
########
