1
10
33
0
#################################
#  PP         P          P    P #
#     P    P       P            #
#   P            PP     P  P    #
############### #################
              # #
              # #
              # #
              # #
              #E#
