2
5
5
1
##E##
#   #
#   #
#   #
##S##

5
5
1
#####
# P #
#   #
#   #
##S##

