1
12
11
###########
#P   P   P#
#         #
#         #
#         #
#         #
##### #####
#         #
#         #
#         #
#         #
#####E#####
