2
50
50
4
-1 -1 -1 1 31 30
-1 -1 -1 1 41 12
-1 -1 -1 1 41 47
-1 -1 -1 1 44 1
##################################################
#P                                  P            #
#                                                #
#                                                #
#              |||||||P         |||| |||||       E
#              |  O  |          |        |       #
#              |     |         P|        |       #
#              |  P  |          |       P|       #
#  O           |    O|          |P    P  |       #
#              |                |        |       #
#          P   |    P|          |   F    |       #
#      P       |||||||         F|||||||| |       #
#                                                #
#                                               P#
#                                                #
#                                                #
#                                               F#
#       ||| |||                      P           #
#       |     |          |  |||                  #
#       | P   |          | O  |      |||||||     #
#       |     |          |  P |      |     |     #
#      P|P   P|          |    |      |     |     #
#       |     |          | P O|      |P          #
#       |     |          |    |      |     |  P  #
#       ||| |||          |    |      |   P |     #
#                        |    |      |     |     #
#                        |   P|      |  P  |     #
#                        ||||||      |     |     #
#                             P      |     |     #
#  ||||||       F                   P|||||||     #
#  |    |                                        #
#  |  PO|     P               S                  #
#  |    |  O                            O        #
#  |  P |               P                        #
#  |P   |                                        #
#  |                                     P       #
#  |    |        ||||||| |||      ||||||||       #
#  ||||||        |         |      |      |     P #
#                |         |      |  P   |       #
#                |         |      |      |       #
#      P         |         |      |      |       #
#           S    |  P      |      |      |     S #
#                |         |      |      |       #
E                |         |      |      |       #
#S               |   P     |             |       #
#                |  P   P  |      |      |       #
#                          |F     ||||||||       #
#                |||||||||||                  P  #
#                                                #
##################################################

50
50
4
0 31 30 -1 -1 -1
0 41 12 -1 -1 -1
0 41 47 -1 -1 -1
0 44 1 -1 -1 -1
##################################################
#                                         P   P  #
#                                                #
#P                                               #
#     P                     P                    #
#  F                                             #
#  F            P             P                  #
#  F                   P                      P  #
#          FF                     P O  P         #
#                                                #
#                        P                       #
#                                                #
#                  P           |||||||           #
#    ||||||| ||||              |O                #
#    |          |              | O   |    P      #
#    |P         |             P|  PP |       P   #
#    |    P     |              |P    |           #
#    |  O      F|              ||||| |           #
#    |     P    |                                #
#    |          |                                #
#    ||| ||||||||                                #
#                                            P   #
#                            |||||| ||||         #
#                            |         |         #
#              F             |      P  |         #
#                            |         |         #
#                            |  P      |         #
#                            |||||| ||||         #
# P                                           P  #
#                P                               #
#       F  ||||||||||          P                 #
#       F  |    P             S                  #
#       F  |   P    |                            #
#          |      P |     P     ||||||           #
#          |        |           |    |           #
#          |                    |    |           #
#          ||||||||||           |    |           #
#                               |    |           #
#                               |   P|           #
#                               |    |           #
#                       P       |    |  P        #
#           S                        |         S #
#                ||||||              |           #
#                |   P|    P    ||||||           #
#S               |    |                          #
#                |   P|                          #
#                |    |                          #
#                || |||    P                     #
#                                                #
##################################################

